5,5;9,5;9,9;5,9
15,6;20,6;20,10;15,10
30,5;35,5;35,9;30,9
40,8;45,8;45,13;40,13
8,18;14,18;14,23;8,23
22,16;27,16;27,22;24,20;22,22
35,18;42,18;42,24;35,24
6,30;12,30;12,36;6,36
18,32;24,32;24,38;18,38
32,30;38,30;38,36;32,36
