10,10;20,10;20,15;10,15
28,10;38,10;38,15;28,15
5,25;15,25;15,29;5,29
25,26;35,26;35,30;25,30
12,40;22,40;22,45;12,45
